Sandwich
8 11 11 5 9
...........
...........
...........
.../////...
......./...
.R...C./...
......./...
###/////...
.../.......
.E./.S.....
.../.......
1 1 7 8 7 4
1 1 7 10 7 6
1 1 8 3 4 3
1 1 10 3 6 3
1 1 3 0 3 4
1 1 3 2 3 6
1 1 0 7 4 7
1 1 2 7 6 7
