Best Size
5 8 10 1 6
///...////
///.C.////
///...////
//////////
//////////
....../...
.S..R./.E.
....../...
1 3 5 6 4 6