In The Cracks
4 7 10 1 5
...../////
.C.R./////
...../////
#.###/////
...../....
.S.../..E.
...../....
1 3 4 5 0 5