For Loop
2 9 10 1 7
....//....
....//..E.
....//....
....######
..../.....
..../.....
....#.....
.S......R.
....#.....